################
#.....~~~~~~...#
#.....~~~~~~...#
#.....######.#.#
#..@..#....#.#.#
#..........#...#
################
